111111
10E001
100C01
10P001
111111