1111111111111111111111111111111111111111
110101000C0000000100000100C001000C111111
110100100C0000000010000000C00000C0000111
1100C0100C0000000001000000C00000C0000111
1100C0010C0000000000100000C00000000CC111
1100C0010CC0000000C0010100C00000CCC00111
1100C0000C0000000000011000C0000000000111
1100C0000C00CC000000000100C0000000000111
1100C0001C00100000C0C00000C0000000000111
1100C0000000010000C0C0000000C000CCC00111
11000C0C10C0001P000000000000000000000111
11000C000000010E0000100000000000000CC111
11000C0010000100000000000000000000000111
110000CC00C000100000000000000000CC111111
1100000C0010000100CC0C000000000000000111
1100000C0010000010CC0C000000000000CC0111
1100000C0011000001CC0C00000000000CC00111
1100000C101000000C1C0C00000000000CC00111
1100010C000100000CC10C001000000000111111
1111111111111111111111111111111111111111