1111111111111
1111111111111
1000000000001
100000EP00001
10CC000000001
1000000000001
100000CC00001
1111111111111
1111111111111
1111111111111
1111111111111
1111111111111
1111111111111