111111111111111111111111111111111111
1E0000000000000000000000000000000001
101000101001000001010010000000101001
101000100101010100010010000000101001
101000101001000001010010000000101001
101000101001000001010010000000101001
101000101001000001010010000000101001
101000101001000001010010000000101001
1P0000000000000000000000000000000001
111111111111111111111111111111111111