11111111111111111111111111111111
1E00000000000001C0000C0000000001
10100101001000001010010000000101
10100100101010100010010000000101
11111111111111111111111111111111